aPPPPPPPT
PPOPOPPPP
PPPPPPOPP
PPPPbPPPP
PPPPPPPPP
